空砖空砖砖空砖空砖空
敌铁空铁空铁敌铁空空
空空空空空空空空空空
铁空水空空铁空水水空
草草草砖草砖草草草草
空砖空砖空砖空砖空砖
空砖空砖空砖空砖空砖
空砖空空空空空砖空砖
空空空空空空空空空空
空空空空空空空空空空